 -2   -3   -2    2    1  
 -3   -3    3   -1    2  
  1    0    2    1    1  
  0    0    4   -2    2  
  0    3    4    0   -2  
