 -3    2    0    3    0    0  
 -2    0   -3   -2   -3    1  
  3    1   -2    3   -2   -2  
 -1   -3    3    1   -2    3  
 -1    1    1    2   -1    2  
