 -1   -1    3    0   -1    2  
 -1   -3   -1    2    0    1  
 -3   -2    1   -3    3    1  
  0    2    2    2    1    2  
 -1    3   -4    0   -3    2  
