 -1    0    3  
  1   -3    0  
 -2   -3   -2  
  0   -2   -1  
 -2    2   -9  
