-10    3   -7    0    0    0  
  1    0   -3   -4    0   -5  
 -3    3   -2   -1    8    0  
 -9    7   -9    8   -1    0  
-10    4   -8    0    7   -7  
