 -3    0   -2   -3    0    0  
  5    0   -4    4    5    5  
  2    0    3    2    3    0  
  5    0   -2    0    2   -4  
  3   -2   -4    5   -1    0  
  4    0    3    4    5   18  
